111111
1E00C1
11P111
111111
111111
111111
111111
111111