11111111111111111111111111111111111111111111111111
1P001110011101111010110111100111010100001110110101
1CC00100110001011000011001111000010111110010000101
1000011000000000011011000E001010110110111110110101
11000000111110100111101111001000011001011100000111
100C0010001011010110110100110010111010010010100101
100C0011011101000010111111010011111101001101110101
10000000001000110011000001010011011010011010101001
11CC1100000000011011001000101010110111111111000011
110C1001110001111100000111100000001000001011001111
111C1000101011001000000110111111010100100111101111
110C1000110110001110011010001100111010010000001001
11100000000110110011010011111100111111111100111111
11000000001000111010101010011010100100010111101101
11010000100010101000000010101001101111111010110111
11100000100010011011110000100001010111010001111001
11011100100100001101010100010100110000001101010011
11000100000000100000101001001000110000001011110111
10110010010000110101010100010011011110111010111101
11101100000011010100001011110100111001011101011011
10010100101110011110100101101100111010110000100111
11111001101111001100011000001111110101110000101111
10101000110101100011101100010110110100001011101101
11010000001101110011010101001011111110110111011001
11111111000000100010110110010111000000010001100011
10110101001010000010101111101001010100011111101101
10011101000000110000000001100001001111001011010111
10111010011000000010101111010111010011010111010001
11011100001010000110111001000011100001101100100001
11001000100000000000000001011011101001111100101101
11100111110011001010101001111100001011101111001011
11000100000000111111011110000111101110100010011001
11101101001001000110011110000000100011000011111101
11000000000101000110010010100110010010111110101101
11001100110111001111011010101100001010000001101001
11100010111111111111100010010101011010101100111001
11100000000100011001111110011010110110000000000001
11000000101010110101001110100011011100000100000111
10000101101110101100010101100110111001000110011101
11100011010111110101011100101001001101100111101111
11000110001111100110100010100111010110000110100011
10011110100110000001101111110011011001100001100111
11000000101000010011111111110000100100101000001101
11110100110001000000111001110000001111100100000101
11001010001110100001010110111100001001010101000001
10100100100010000000010000011111101001111110100101
10101111000001110011100110101111011101001011110101
10110001010101101110010111011000000101110001000011
10000000000010001110011111001111001010101100001101
11111111111111111111111111111111111111111111111111
