1111111111111111
10010000000C0001
1000011111000001
1P0011E000000001
1000000000000001
1000000000000001
1000000000000001
1000000X00000001
1000000000000001
1C00000000000001
1000000000000001
10000000000C0001
1000000000000001
1000000000000001
1000000000000001
1000000000000001
1000000000000001
1000000000000001
100X000000X00001
10C00000000C0001
1000000C00000001
1111111111111111
