1111111111111111111111111111111111111111111111111111111111111111111111111111111111111111111111111111
1000000000000110000010001010000000000000001000000000101000000100010000100101000001010001000100001001
1010000000010000100000011000001010100000010000000010000100001100000000001100101010000000001100000001
1100000010000000000001000010001000010000100000000100001000000000000101010000100100000101001010001001
1100000000000000100010001010000000110000000000000000000000000100000000000000000000000000001000000001
1000110000000010000001000010000001000011000000000000000000000100000100000000000100000001001000001001
1C00000000000010000000000101000001111000101110000100000000000000001001011000000011010010111100000001
1010000100000010000011000010100000000000000000000000000011000000100000100001000000000000010110100001
1101000110100000100010000000100000000000000000000000000010100001110000000000000100110000000000001101
10101C0000000100100100000000001000100100000001010000000000000000100000000001100000001000000010100001
11C0010111100000000000001001001000100110000000000011000100010001000000100010100000000001100010111001
1100001000000110000100000000001000000100100010010010000001000011011000100000001001000110000000110001
1000100000000111011000001000001100010101100010110001100010000000010001010111010000010001000000000001
1000000000000000000000000000000000100000000100000000000100000001000001110100010000100000000000100001
1000000000000100000000100100000011100000011000000110100000001100000100000000010001100000001100000001
1000010000000110000000001100010100000100100000010000100010001000100000000000000101110001000000000001
1000101000000000001000000000000000000000000000001000000000000100000001000010000111000000000000101001
1011101100000000010010100000110000010000000110100100000000100101000000001001100010100101001101001001
11P0000000001001010100000000000010000010000010000111010001100000001000000100100100000000000000000011
1011000100101000000000011000000000001000000011000001000100000001010000000001100001000001001000000001
1100001110101001101001100001000100101000100000001100000010010001000100010010100010000000000010010001
1000010010000001010001011000000000100100000000001000001000100000000000010111000000000000000101101011
1110100110001010011000000010011000010001101000001000001001001000100001000010100101000100000000001011
1000010000010100101100010000100010010100000000100000001000100000000C00000011010010001000100000010101
1000000000001100010000010000010101001000000001010101000001110101000000100000000000001000000001000111
1001000000100010110100000010000010010000111000101000010000010001000010001000110000010000011000001011
1000000100001100000100001010011001001010010100001000000100100000000100101010100001100000000100000001
1E01010111100100011010000100001000011011000010000010010000011100010011001011000001100000010001100001
1000010011010000000001001101001100000110000001000000001100000001110100100010001000101011010000000001
1100000111101010110100100000101001110100100011011000101110001000100001000001101000101000100100000011
1000000000000110010010011011001000001000000100010010111100001000010001100100000001110000000000000001
1001001100100001010001010010001101001101000000110011101000100001001010100010000001010000000110000111
1C00100100000110001100101100010010111100100000010000100100000001001101000000011100000101001010000101
1000110000100001001110010001001100011101101100000111010001001010100000011010001100111111001000000001
1010000001000000011000111111010100000100000000100000100000000000001010100001001001100001010001001101
110101000101011000010101000100001001101110000000C000110100000100011000101100000001000110111010001001
1001000100000001111010001100000000000001010110000000100101000000011011000111100001000000001000010001
1110000111000001001100100001001001100000000110000000010010110111000011100000000101110000000000000001
1010011010000100101000010010000110000110010011110110000101001000000010000111100000010010000000101001
1100000100100101010000001100000000110011000100000000011000000000101101010000010000010010010001000101
1100100011010100101000000000000000011001110000010100100010000010100000001001110000000101010000111001
1001000000010010000110000100100001011000010000000110001110010000000000100100100011100001000001011001
1000100101100000000000000110110000010000010011000000000000001110100001000010000001110000000010000001
1000110000100001010000110111100010101000000000000000110010000010010110110110011000000001111000000001
1001000000100011010000000000000000001100100010111000010101100100100010001010010001000110000010001101
1100000000010111011010000100000000110100111100100000101000000010010111010101001011110110110001101001
110100100001101010100111001010000000100000C000100000010000100001000011110000100000011000001010101001
1100000110011001110010000000001000010000001000011100100000100111000110101000001000101000010000000011
1001101000100000000001000000110101100000000100000001000010011011001000010010001010000000010000000001
1001100100001010001100100011111000010010001000110111000100001100100000001001100010000000010000010001
1000000110100011000100000001010011000010000100100010010100010000011100001010000011100000011000010111
1000001001001000100010101001000000001101000000000000001100001000000011000000000010000110010010011101
1001111011101000110100001110000101101100000001001110001001100000001000000010011100010101100000010011
1101110011011010001000011010010011000000000000000100000100110011010000000000010000011011100000010111
111010C000011101100001010101100110000001001000000011110101101001100000001101000100000111110100000111
1010001000010100000100001001000100000101010001010111000110111000000010000001010110101001011000010001
101000110000100010001010000C001000110101101010010010000000010110000110000000010101100010011000100001
1000111001111110000001010100000101000000000000000100000000001000000111100001000100000011100101010001
1000000011101000000000001001110011101001000000001100001111001010010100000010010001000000011000101001
1010000000001010110000011000000000000001100110101001110101100011000000000011010010011000110011001001
1101010010101100100001101000000000100010100000100000001011110000001000001101000000010000000000100001
1111110110100100000110010100001000000000010100000000100100100101010100100111100101000100000000001001
1111110100000010000100000100010011100010001000001000000000001011000010000010000110001111001100010101
1001111110000000000100010101000111100111101000111011101001100001100100010010100000001000001100001011
1000001001001000010000000010000000011101000101010010100100111000001001100011010000000110000110000101
1001110110000000110000001000010010010110110100100000000100000100110101101000101000100000101000001001
1001000000100011100001000010001010010000110001011100000001001100100010101100001100001000010110000001
1000001000110001000110110111000010100001101001100100001000000111000000000100000000010111100100101011
1000010000000100001010001100010000010101001010100110100010011000010001000101101000110011010001010001
1000000011110001100010001000100000001101010111100111100011101000101000011000100000000000000010000111
1001011100000111000000100101100010110000111001001010000100001010000010000000100100001011000000011011
1010000011100011100001100001000010000100000001101101010111110000100001001000000000100001100111001101
1001001000001001001101001110100000110001011000010011010000001010000010000000000000000000000000100011
1110000001010101000000100101100001001000000000000010100100001101101100001100011111100011010010000111
1010100101000100110010000010000110010001010100011110001101100111011000001000010101100000100010100001
1100100000101100000100100110000000010011111010001100100000000101001001100000000100110010000011000001
1100000101011001111101100110001000010001001000000101100000001101000000000111100011100100101001000101
1011000000001000001010110010100000110001010011111100100101000000010011000011000001010000100100001011
1110001011110110000000010000111110101000010011010100111101000010110100001000110100011110000000100001
1000011000000000000100000010010110010010000000000110000001001100100000010010100110101000011000000101
1000001101001000001010000011100000000100100000010001001110000110001001110001001010101001010000000111
1011000100001101110010110100100110010100101011000000000000000010000000010100000101101011000100010001
1100001101001000011010010000001000001011101001000101001000110000001011010000000000101110001010111111
1000011000011000000011100111000000000000100100101000001010101001000010101000101001011001000101000101
1000000001111001000011000000010010000101011010000000100101010010000101010100100000000010000001101001
1000100011000011100010100100000010000001000111101010000000100110110001000001001000110000101010100011
1000100110001001001001000010000100100001000110010011011100010001000001010000000010001010000100100001
1001001110110100001110011000100100000110100111100110010101000000000100010000000000001010101001000011
1110001000010010111011000110010000011000111100000001000100001111010010101000100000000000101000000001
1101010001000001011011011010000000101001000100100101010000000000000001111000000000100011010110100011
1C00010000101010111101011001010101001010001110111010000001111100010000100001100001000000000000010001
1000101010000100101100110010110010000001011000000010100001001100000000000001100101000110001110100001
1001110000001011000001110001100011001010110100101100000000100101010010100001000100000000010000000001
1100001000000011011000010110010010010000000010000101100000001110010110110010000111100010000001100111
1010100000000000010001001110010000100000110010010000100100001010000100010000000000000010100100110011
1000000010100001100101010000011000011000000000011100000101000000000000000010100111111001000100110001
1000010001100010000011110000000001000111010000000000000011110010100110000001001010000000000111001001
1000110000011001000100000010100001000000010011010111010000100001011011000010000011100000100100011101
10C0010111000000100000000000001001001001101000101110010000100001001110100001000000000000110101100001
1111111111111111111111111111111111111111111111111111111111111111111111111111111111111111111111111111
