1111111111111111111111111111111111111111111111111111111111111111111111111111111111111111111111111111
1100100100000111000110000101000010010000000010001000010000000000001000000010011000000001000001001101
1001000000000100110001000000010001100100101001001000010001010000000100000000000001000001001000000001
1010010100000010000110000000111000000000001110010011110001010011011001111001000010000010100000000001
1000000000000000000001000000010000000001000011000000001000010100000101000000000000110000000000000101
1101101000000010001000101000100000110000100000001100100100010011011101000001000001000000010000100111
1010E00100010001010110000000000000000000010010000100001100000010000000000000000000000000100000100001
1000010000011000100001010001001101001000100010000000100001001000000001000000110000000001000101100001
110011P000101010000000101110000100001000010010101001000010001100101000001100010000000100001011011011
1000001101100001010110011001001010010100000111000000000100000000010000000000000000100000000000000101
1100010010010000010000001001100000000011000010100000110100000000001100001110001101000000000010000001
1100011000000001000110001001001000000000010000111000001011010010001010000101000111010010010111100001
1011110101010010000000000001010100110011100000100010010010000010001000001100000000010000110000001001
1110C10100110101001100010001101000001000010000111001010010101000001010010000000101110111001000000101
100X000011010010010010111010100001000111001000001001100011001100001000100001110110000010010100000001
1100010100000010011100010011010000000100000000000111011011110011010000000000010000010000011101000011
1100010111011001101111101010101010000000000010100001101100000000001101111000000011001001110101110101
1011000000010000000000000100010100111000000000000110000100010010010111000000110110010000001001010111
1001000100100001100010110000100000010000000C00000000100000101010001110010001010000011111010000011011
1000011111000010110000000101010010000000000000100100010100111010111000010000001010100000101111011001
111CX00001000000000001101000000100001000001000000000011111111100100100100100001001001100000111000001
1101100000000010000011101101100110111000000000100000110101011001011000011110000101001100000110000111
1000000101000001000000110010101110101000000000001001100000000101000010110110111000010111011100010011
1011001000001011000000000100100011001000000000000000001010000010000000100000100110000000011010010001
1000010000000011000000010101110000000100010010001110010100100000000110000000000001000001000000000001
1010000000101010010000101001000000001101001011100000100101010000010000100000000001100010000110000001
1010000000101000000110110100000011111001110100001100000011101010011000100000100100100010011010010101
1000011100001101011100011010011010100010101000010110101010010000010011110110101001000111010000001101
1010010011111011111000000111110101010000000010101110101000000101001000000100001010010000110000100101
1010000000111110000010000100100100010101000000100000011100001010000101000001001001100000001100100011
1000100000011000010100000010100001001101010000000011010110110010100100010101011001110001010000000011
1110000001010000000000000010110001000101100000011100010000000001011010001101000001100010001000000011
110111C000010000100000000000010101000010011110010011010100001100101011001001110011000100100100110111
1011000000010000000000000100011110100011000010011100000010101101000111010010101000111000000100001001
10000100000000001011000010100000111100110011010000010100101000110000C0001000000111000000000100001001
1110000000011000000111010000010010000100110100100101100100001101000000010000011000000011011000000001
1111010100001110010000000000110011100100111011000011100011001100001100000000001000010010001000000101
1110001100001001110000001010101100100010001000100001001101000100101010101001001010000000000110010001
1000000000000100011001000100001101001000010000101110100000001000101001001000001010110001100100010001
1010010010000011101001000111011100010010100100110000101010010000000000000001101100101011010011110011
1001110000111100011110011100100000000110010110000110001100000110110000001001000111001100000001100001
1010010100111001111000001100010000000000000011001010100000001100110010100000000000000000111000100101
1001000100011011100010010000000100000000101110000001000000000110101010110000010001111000001001101001
1010100000000000100001001000001111010101000000000001010001010001011010010000000000010110100001001001
1000110001101001000000101011000000010010001010010101000100000100001000000100100110111000110010010001
1001000001000000110111000000000011000100100101100011001001000101001001000110100001000010000001001101
1101001101001000001000001100000100100101110001001000000000100100100011110000010111000110010010000001
1010010010010000110111110000010001010101000001000000010000100010000111011100001000100000100010010001
1000111000000000000001100000100110000000000101000010000000000001101000001000000100110110101000110001
1000000111000000000111000001001000000001000000110011000010010000000110000000111100100000010000010111
1010010100000000000011000100000000000000000000001000010000010110000100000100000010000110101110100101
1000000100000001101100001100100001000000101000001110010000000101111011000010001001000100010000100001
1101000000000010000001000110010110100100011101010010111110101000001001100000010010000110000000101001
1011011C00100010000000010101000100001100001000010100001000000010000100101001010011000100101001001001
1100010000000000010101100000001010010000000010001010100000101000011001010100000010001000010100110111
1000010111101000000100001110100111011110010100000000000101010000000000010111001001000010001000000001
1100100101100110010100000000000001100100010011000000001011111010010000110000000100001100000010001001
1000000001100011110000100000010100111001110010010000100011000011000001000010010001011100000011000111
1100010011010100000000000001010000000110001011001111100000000100000000111111010010001000101000000001
1000100000001110000000000011000110101001000010101101111010011000001000100000101000110001010000000001
100C101110100010010000110000000100100011001001000000101000110100101110100010001001010000100000100011
1001001000100111011100001000001100001011000110110111101011101001100101000000000101110100101101010011
1001110000000000001011100001100001001110011001010101000010000110001110100010100010101100000000100011
1010100100011000001001101011100000000100010101000110101000000101110000010001000100000111000001010101
1011000110100110000001010110001101000000000101100100001100101010110101100110100011110001100110010011
1000111111001111101111010000111011110000010000110011010010110000101110110110110101010101000011000011
1010000000000110010110001100100010010001001100010100000010110110001010101001000010100000001010001011
1100011100010100100110001001000110110000000000111001011010100001100000010111100011000000010001011101
1011000001110111000101101010001010111111000010100110000001000000100000001000001100101101101010100001
1110111011000000001101101001001100011101010000010101000100010001010110000000100010110100100000110111
1000001101011100110001011101011001010111001100100000110000010110000111001000100100100010001111000001
1110000100110001001010000010101100010110010010100000001000100000111101100001011100101111100011101101
1100001001010000101000101100101010001010000011000001000010101110000111011101001100000111011001010011
1100110100100000010100110100101010010001000100000100010011100001100111010010010100011000010010101101
1010011001011010101000001000100000010000000101001110001001000000001000001101101010100000001100000111
1100001011101010111110010000000000001110011100001100011011000101000001011010101000110000101001000001
1000000101101001000000100000010000000101001010000101001010111101100001001011000110110011110001001101
1110110100000001100011100110000110001010011111101000010111010100111001101001101101110001100010101111
1010001011110000010011110101001000010011111000100100100010110000001100010100110000100000110100101111
1000000000101000000010001000110011010000110000001000001010010001011110001100101110100011001011000101
1101000111000000100101011000011011000000000000000010000000001000101000001100001001110010010000011001
1000100110100001000100101001011001011010110000001110101001000000000010110100101010101100001001111111
1111101111111101011000110000011101110110010010100101000110100011111001100001010000110010100001000101
1000100010011100011010000010000010000100100000001001100111011001000100001011011101001011101000000101
1000000110100001100101110000000001100000000001011110001000000101000010010101110111101101101010000011
1001110100110001001001101010000100000000011000100101100100001010000100100000101100001010000010100101
1100001001000100100011101110000110011000000000001001001001011010101000000000100011010100001001001001
1000100000110011110000100001000001110010000100011000001100100111101001010100000101000110010010000001
1001010110000001001011100100110010000010001100010110100010100101100001010011001000101000100111010101
1000100011000000110101011001011110000101111010000000011101011001000011111100011000100001110001110101
1111000010001100111001010100011001110010101100100000100100100001101001101010100010011010110000110111
1011000101100001001001101010101000111001000110000000100010011100001011000110001001010111011001001001
1101100100001000101000100001000010111010010010011000101010100010100100001100001001000011001010100011
1010101010000110100001100100000001101111000110001010000100110100101101100001000001100111101000001011
1000010010000000000111100000000000110000001100001100011110100100001010111100010000010000100100110001
1101001010111000100010000000100101000010000100000010000011100101001011100110010110010100100000000001
1000101010011000001010100010010100111000111101100011101000100101000000111001010100100001000001000001
1100111111001001000000100000100011100000010100010010010100100100001100111011001001010010010100100001
1000000110001000011011000000000011111010100011001011000010001100110000100000100000011011000011010011
1111111111111111111111111111111111111111111111111111111111111111111111111111111111111111111111111111
