1111111111
1PCCCCCXC1
1CCCCCCCC1
1CCCCCCCC1
1CCCCCCCC1
1CCCCCCCC1
1XCCCCCCC1
1CCCCCCEC1
1CCCXCCCC1
1111111111
