1111111111
1P00000XC1
1000000001
1000C00001
1000000001
1000000001
1X00000001
1C00C00E01
1000X000C1
1111111111
