11111111111111111111111111111111111111111111111111
11001001000001110001100001010000100100000001000101
10010000000001001100010000000100011001001010100101
10100101000000100001100000001110000000000011001001
10000000000000000000010000000100000000010001100001
11011010000000100010001010001000001100001000000111
1010E001000100010101100000000000000000000101000011
10000100000110001000010100010011010010001001000001
110011P0001010100000001011100001000010000101010101
10000011011000010101100110010010100101000001100001
11000100100100000100000010011000000000110001010001
11000110000000010001100010010010000000000100011101
10111101010100100000000000010101001100111000010001
1110C101001101010011000100011010000010000100011101
100X0000110100100100101110101000010001110010000101
11000101000000100111000100110100000001000000000011
11000101110110011011111010101010100000000001010001
10110000000100000000000001000101001110000000000011
10010001001000011000101100001000000100000000000001
10000111110000101100000001010100100000000000010011
111CX000010000000000011010000001000010000010000001
11011000000000100000111011011001101110000000010001
10000001010000010000001100101011101010000000000101
10110010000010110000000001001000110010000000000001
10000100000000110000000101011100000001000101000111
10100000001010100100001010010000000011010011110001
10100000001010000001101101000000111110011100000111
10000111000011010111000110100110101000101010001011
10100100111110111110000001111101010100000001010111
10100000001111100000100001001001000101010000010001
10001000000110000101000000101000010011010100000001
11100000010100000000000000101100010001011000001111
110111C0000100001000000000000101010000100111001001
10110000000100000000000001000111101000110001001111
10000100000000001011000010100000111100110010100001
11100000000110000001110100000100100001001100010011
11110101000011100100000000001100111001001111100001
11100011000010011100000010101011001000100010010001
10000000000001000110010001000011010010000100010111
10100100100000111010010001110111000100101000011001
10011100001111000111100111001000000001100101000011
10100101001110011110000011000100000000000001100101
10010001000110111000100100000001000000001011000001
10101000000000001000010010000011110101010000000001
10001100011010010000001010110000000100100011001011
10010000010000001101110000000000110001001000110001
11010011010010000010000011000001001001011100100101
10100100100100001101111100000100010101010000100001
10001110000000000000011000001001100000000000100001
10000001110000000001110000010010000000010000011001
11111111111111111111111111111111111111111111111111
