11111111111
1C0000000E1
10000000001
1P1X0000001
11111111111
